a (preposition) - to
abondance (noun) - abundance
absolue (adjective) - absolute
absolument (adverb) - absolutely
abusait (verb) - abuse
accent (noun) - accent
accordaient (verb) - grant
acide (adjective) - acid
acide (noun) - acid
acier (noun) - steel
admet (verb) - admit
admirable (adjective) - admirable
admiration (noun) - admiration
admiratives (adjective) - appreciative
admire (verb) - admire
adroite (adverb) - right
affilée (adjective) - sharp
affluence (noun) - pouring out
afin (?) - ???
agit (verb) - act
agiter (verb) - shake
ah (interjection) - Ha!
aide (noun) - aid
aiguille (noun) - needle
aimaient (verb) - love
aimait (verb) - love
aimanté (adjective) - magnetic
aimantée (verb) - magnetize
ainsi (adverb) - thus
ainsi (conjunction) - as
ajoutez (verb) - add
ajouté (verb) - add
allais (verb) - go
allait (verb) - go
allemagne (noun) - Germany
allemand (adjective) - German
allemand (noun) - German
allemande (adjective) - German
allemands (adjective) - German
allongeaient (verb) - lengthen
alors (adverb) - then
ambassadeur (noun) - ambassador
ambassadeur (adjective) - ambassadorial
amenèrent (verb) - bring
amour (noun) - love
ancien (adjective) - former
ancien (noun) - former
ancien (prefix) - ex-
anciennes (adjective) - former
anciennes (noun) - former
animant (verb) - animate
années (noun) - year
ans (noun) - years
anthracites (noun) - anthracite
aplomb (noun) - aplomb
apparition (noun) - appearance
appartenait (verb) - behove
appellations (noun) - appellation
appétit (noun) - appetite
après (adverb) - after
après (preposition) - after
arracha (verb) - snatch
arrangé (adjective) - fixed
arrosé (verb) - water
arrêtait (verb) - stop
aspect (noun) - aspect
assez (adverb) - enough
assidus (adjective) - hard
assidûment (adverb) - assiduously
assis (adjective) - seated
associations (noun) - associations
atome (noun) - atom
attendait (verb) - expect
attendis (verb) - expect
attendre (verb) - expect
attention (noun) - attention
attirait (verb) - attract
aucun (adjective) - no
aucun (pronoun) - none
aucunement (adverb) - nothing
auditeurs (noun) - audience
aujourd (?) - ???
auquel (?) - ???
aussi (adverb) - also
aussi (conjunction) - and
aussitôt (adverb) - immediately
auteur (noun) - author
autorise (adjective) - authorized
autrefois (adverb) - once
autres (adjective) - other
autres (noun) - remainder
avantage (noun) - advantage
avare (noun) - miser
avare (adjective) - stingy
avidité (noun) - greed
avoir (verb) - have
avoir (noun) - asset
avouerai (verb) - confess
avril (noun) - April
axel (?) - ???
beau (adjective) - beautiful
beau (noun) - beautiful
beaux (adjective) - beautiful
beaux (noun) - beautiful
becquerel (?) - ???
belle (adjective) - fine
belle (noun) - belle
belles (noun) - belle
bibelots (noun) - trinket
bibliomane (noun) - bibliomaniac
bien (adverb) - well
bien (noun) - good
bien (adjective) - right
bitumes (noun) - bitumen
bizarres (adjective) - weird
blessé (adjective) - injured
blessé (noun) - casualty
blond (adjective) - blond
blond (noun) - blonde
bois (noun) - wood
bon (adjective) - good
bon (noun) - voucher
bon (adverb) - then
bond (noun) - leap
bonheur (noun) - happiness
bonheur (adjective) - welfare
bonne (noun) - housemaid
bonnes (adjective) - good
bouger (verb) - move
bouquin (noun) - book
bourgeons (noun) - bud
boutique (noun) - shop
bozerian (?) - ???
brewster (?) - ???
brimborion (?) - ???
brique (noun) - brick
brisure (?) - ???
brusquement (adverb) - suddenly
brutale (adjective) - brutal
brutale (noun) - brute
bâillant (verb) - yawn
bâiller (verb) - yawn
cabinet (noun) - cabinet
cailloux (noun) - pebble
calomnie (noun) - calumny
canaux (noun) - channel
canne (noun) - cane
capitaines (noun) - captain
car (noun) - car
caractère (noun) - character
caractères (noun) - print
cartel (noun) - cartel
casquette (noun) - cap
casse (noun) - breakage
cassure (noun) - break
cassât (verb) - break
ceci (pronoun) - this
ceci (adjective) - following
cela (pronoun) - it
celle (pronoun) - that
celui (pronoun) - that
centre (noun) - center
cents (noun) - cent
cependant (conjunction) - however
cependant (adverb) - though
cesse (verb) - stop
cet (pronoun) - this
cet (adjective) - that
cette (pronoun) - this
cette (adjective) - that
ceux (pronoun) - those
chalumeau (noun) - blowtorch
chambre (noun) - room
changements (noun) - change
chanter (verb) - sing
chapeau (noun) - hat
chaque (adjective) - each
chaque (pronoun) - either
cheminée (noun) - fireplace
chez (preposition) - in
chimie (noun) - chemistry
chose (noun) - thing
choses (noun) - things
chronique (adjective) - chronic
chronique (noun) - chronicle
ci (?) - ???
cinq (noun) - five
cinq () - five
cinquantaine (noun) - middle age
classait (verb) - classify
closs (?) - ???
coin (noun) - corner
collection (noun) - collection
colère (noun) - anger
colères (noun) - anger
combien (phrase) - How many?
combinaisons (noun) - combination
commande (noun) - order
comme (conjunction) - as
comme (preposition) - as
comme (adjective) - such as
comment (adverb) - how
commençaient (verb) - start
commençait (verb) - start
compagnie (noun) - company
compote (noun) - compote
comprenait (verb) - understand
comprendra (verb) - understand
compte (noun) - account
condition (noun) - condition
connaissais (verb) - know
connaissait (verb) - know
connaissance (noun) - knowledge
connaîtra (verb) - know
connaître (verb) - know
conscience (noun) - consciousness
conservateur (adjective) - conservative
conservateur (noun) - conservative
considéra (verb) - consider
considérables (adjective) - considerable
considérait (verb) - consider
consulter (verb) - consult
contenant (verb) - contain
contenu (noun) - contents
contenu (adjective) - restrained
continua (verb) - continue
contre (preposition) - against
conversation (noun) - conversation
conviens (verb) - admit
couramment (adverb) - fluently
cours (noun) - course
court (adjective) - short
court (noun) - court
couverture (noun) - coverage
coûter (verb) - cost
craquer (verb) - crack
crasseux (adjective) - filthy
crevette (noun) - shrimp
crevettes (noun) - shrimp
cria (verb) - shout
criait (verb) - shout
cris (noun) - shouting
cristallisations (noun) - crystallization
cristallographie (noun) - crystallography
croire (verb) - believe
croisent (verb) - cross
croissance (noun) - growth
crûs (verb) - grow
cuisine (noun) - kitchen
cuit (adjective) - cooked
culinaire (adjective) - culinary
dangereux (adjective) - dangerous
davy (?) - ???
degré (noun) - degree
demandai (verb) - request
demander (verb) - request
demandes (noun) - request
demeurait (verb) - remain
demi (adjective) - half
demi (noun) - half
demie (adjective) - half
demie (noun) - half
dentelé (adjective) - jagged
dents (noun) - grinder
depuis (adverb) - since
depuis (preposition) - since
dernière (adjective) - last
dernière (noun) - last
derrière (adverb) - behind
derrière (noun) - behind
derrière (preposition) - behind
dessert (noun) - dessert
deux () - two
deux (noun) - deuce
devait (verb) - have to
devant (adverb) - before
devant (preposition) - before
devant (noun) - front
devins (verb) - become
diable (noun) - devil
diable (adjective) - wretched
dieu (noun) - god
dieux (noun) - God
difficiles (adjective) - difficult
difficulté (noun) - difficulty
différence (noun) - difference
dimanche (noun) - Sunday
dira (verb) - say
dire (verb) - say
dis (prefix) - un-
disait (verb) - say
disant (?) - ???
discontinuaient (?) - ???
disparaissait (verb) - disappear
dit (adjective) - said
divisions (noun) - division
dix (noun) - ten
dix () - ten
document (noun) - document
doigts (noun) - claw
doit (verb) - have to
donc (conjunction) - therefore
donc (adverb) - consequently
donnait (verb) - give
dont (pronoun) - whose
dos (noun) - back
double (adjective) - double
double (noun) - double
doute (noun) - doubt
douzième (adjective) - twelfth
douzième () - twelfth
droit (adjective) - right
droit (noun) - right
droit (adverb) - due
dumas (?) - ???
dureté (noun) - hardness
dut (verb) - have to
décline (verb) - decline
décoloré (adjective) - discolored
découvertes (verb) - discover
défaut (noun) - fault
déja (adverb) - already
déjà (adverb) - already
démonstrations (noun) - demonstration
dénominations (noun) - denomination
déployait (verb) - deploy
dérider (?) - ???
désirer (verb) - desire
détails (noun) - details
détourner (verb) - divert
détresse (noun) - distress
dévoré (verb) - devour
dévoué (adjective) - devoted
dîner (noun) - dinner
dîner (verb) - dine
ebelmen (?) - ???
edwards (?) - ???
effet (noun) - effect
eh (?) - ???
embarrasser (verb) - embarrass
employés (noun) - employee
empressement (noun) - willingness
encastré (adjective) - built-in
encore (adverb) - still
endroit (noun) - place
enfermé (adjective) - confined
enfin (adverb) - finally
enfoui (verb) - bury
enfuit (?) - ???
enjambées (verb) - span
ennuyais (verb) - bore
entendre (verb) - hear
enthousiasme (noun) - enthusiasm
enthousiaste (adjective) - enthusiastic
enthousiaste (noun) - enthusiast
entrant (verb) - enter
entre (adverb) - between
entre (preposition) - between
entreprendre (verb) - undertake
escalier (noun) - staircase
espèces (noun) - cash
essayer (verb) - try
européenne (adjective) - European
exact (adjective) - exact
exclamation (noun) - exclamation
existence (noun) - existence
expliquer (verb) - explain
expression (noun) - expression
expédition (noun) - shipment
expériences (noun) - experiences
extrême (adjective) - extreme
extrême (noun) - extreme
fac (abbreviation) - uni
facile (adjective) - easy
facilement (adverb) - easily
facilement (phrase) - in a velvet glove
facilité (noun) - ease
faim (noun) - hunger
faire (verb) - do
faisait (verb) - do
faisant (?) - ???
faite (noun) - ridge
faits (noun) - fact
faits (adjective) - ripe
fallait (?) - ???
fameux (adjective) - famous
faute (noun) - fault
fauteuil (noun) - armchair
façade (noun) - façade
façon (noun) - way
faïence (noun) - earthenware
feint (adjective) - pretended
fenêtres (noun) - window
fer (noun) - iron
ferais (?) - ???
ferez (verb) - do
fermait (verb) - close
ferme (noun) - farm
ferme (adjective) - firm
fermés (adjective) - closed
feuilles (noun) - sheet
fiers (adjective) - proud
filleule (noun) - goddaughter
finissent (verb) - end
firent (?) - ???
fis (?) - ???
fit (?) - ???
flacon (noun) - bottle
fleurs (noun) - flower
foi (noun) - faith
fois (noun) - times
folio (noun) - folio
forme (noun) - form
forment (verb) - form
fort (adjective) - strong
fort (noun) - fort
fort (adverb) - highly
fourcher (verb) - pitchfork
fourneau (noun) - furnace
fracas (noun) - crash
frais (noun) - costs
frais (adjective) - fresh
franklin (?) - ???
friand (?) - ???
furetant (verb) - snoop
fureur (noun) - fury
fusibilité (noun) - fusibility
fâché (adjective) - angry
garderai (verb) - keep
garni (noun) - furnished room
garçons (noun) - boy
genre (noun) - kind
genres (noun) - kind
ghélénites (?) - ???
glissa (verb) - slip
glisser (verb) - slip
globe (noun) - globe
gonds (noun) - hinge
gonflent (verb) - inflate
goût (noun) - taste
grammaticales (adjective) - grammatical
grand (adjective) - large
grande (adjective) - large
grandes (noun) - seniors
grands (adjective) - large
graphites (noun) - graphite
grave (adjective) - serious
graüben (?) - ???
grec (adjective) - Greek
grec (noun) - Greek
grecques (adjective) - Greek
grimoire (?) - ???
grinçait (verb) - squeak
gros (adjective) - large
gros (noun) - fat man
grossier (adjective) - coarse
grossier (phrase) - rough and ready
grâce (noun) - grace
guère (?) - ???
gymnases (noun) - gymnasium
génie (noun) - genius
géologiques (adjective) - geological
géologue (noun) - geologist
habitation (noun) - home
habituelle (adjective) - usual
hambourg (noun) - Hamburg
haussant (verb) - raise
haut (adjective) - high
haut (noun) - top
haut (adverb) - in heaven
heims (?) - ???
heures (noun) - time
heureusement (adverb) - fortunately
heureux (?) - ???
hevelius (?) - ???
hochant (verb) - shake
homme (noun) - man
hommes (noun) - men
honneur (noun) - honor
houilles (noun) - coal
hui (?) - ???
humboldt (?) - ???
humphry (?) - ???
hâter (verb) - hasten
hésiter (verb) - hesitate
hésiter (phrase) - be at one's wits' end
i (?) - ???
ici (adverb) - here
identiques (adjective) - identical
idiome (noun) - idiom
idiomes (noun) - idiom
ignorant (adjective) - ignorant
ignorant (noun) - ignoramus
ii (?) - ???
illisible (adjective) - illegible
imagination (noun) - imagination
immémorial (adjective) - immemorial
impatience (noun) - impatience
impatiences (noun) - impatience
impatient (adjective) - impatient
impie (adjective) - impious
importe (adjective) - imported
imprimé (adjective) - printed
imprimé (noun) - print
improbables (adjective) - unlikely
impétueux (adjective) - impetuous
impétuosité (noun) - impetuosity
in (prefix) - un-
incendie (noun) - fire
incident (adjective) - incident
incident (noun) - incident
incliné (adjective) - inclined
indifférence (noun) - indifference
indécis (adjective) - undecided
indécis (noun) - ditherer
inestimable (adjective) - invaluable
infirmité (noun) - infirmity
inflammables (adjective) - flammable
inquiétaient (verb) - worry
insinuai (verb) - insinuate
instants (noun) - moment
instants (adjective) - urgent
instruisit (verb) - instruct
interjections (noun) - interjection
interpellait (verb) - call
interroger (verb) - question
intimité (noun) - privacy
introuvable (?) - ???
intéressât (verb) - interest
invention (noun) - invention
inventés (verb) - invent
irascible (adjective) - irascible
islandais (adjective) - Icelandic
islandais (noun) - Icelandic
islandaise (adjective) - Icelandic
islandaise (noun) - Icelandic
islande (noun) - Iceland
jamais (adverb) - never
jambon (noun) - ham
jaunâtre (adjective) - yellowish
jeté (adjective) - thrown
jeune (adjective) - young
jeune (noun) - youth
johannaeum (?) - ???
joignait (verb) - join
joli (adjective) - pretty
jouissait (verb) - enjoy
juif (adjective) - Jewish
jules (noun) - stud
juron (noun) - oath
jusqu (?) - ???
juvénile (adjective) - juvenile
kringla (?) - ???
könig (?) - ???
königstrasse (?) - ???
laboratoire (noun) - laboratory
laissait (verb) - leave
lame (noun) - blade
langue (noun) - language
langues (noun) - language
large (adjective) - wide
latin (adjective) - Latin
latines (adjective) - Latin
leipzig (?) - ???
lequel (pronoun) - which
leçons (noun) - lesson
lidenbrock (?) - ???
lieu (noun) - place
lignes (noun) - line
lignites (noun) - lignite
limaille (noun) - filing
lithoïdes (?) - ???
livre (noun) - book
livrer (verb) - deliver
loin (adverb) - far
loin (adjective) - distant
long (adjective) - long
longe (noun) - loin
lorsqu (?) - ???
lunettes (noun) - glasses
luttait (verb) - fight
là (adverb) - there
là (pronoun) - thither
lèvres (noun) - lips
magnifique (adjective) - magnificent
mai (noun) - May
maigre (adjective) - lean
maigre (noun) - lean
mains (noun) - hands
maintenant (adverb) - now
maison (noun) - house
maisonnette (noun) - small house
mal (noun) - evil
mal (adverb) - amiss
mal (adjective) - untimely
malgré (preposition) - despite
malgré (adverb) - all the same
malheureusement (adverb) - unfortunately
malheureux (adjective) - unfortunate
malheureux (noun) - unfortunate
manganèse (noun) - manganese
manger (verb) - eat
mangeront (verb) - eat
manquait (verb) - miss
manquer (verb) - miss
manquèrent (verb) - miss
manuscrit (adjective) - manuscript
manuscrit (noun) - manuscript
marchant (verb) - walk
marteau (noun) - hammer
marthe (?) - ???
mathématiques (noun) - mathematics
matin (noun) - morning
maître (noun) - master
mentir (verb) - lie
merveilles (noun) - wonders
merveilleux (adjective) - wonderful
mettait (verb) - put
michel (?) - ???
mieux (adverb) - better
mieux (noun) - rally
milieu (noun) - medium
mille (noun) - thousand
mille () - thousand
milne (?) - ???
mince (adjective) - thin
minéral (adjective) - mineral
minéral (noun) - mineral
minéralogie (noun) - mineralogy
minéralogique (?) - ???
minéralogiste (noun) - mineralogist
minéraux (adjective) - mineral
minéraux (noun) - mineral
mm (?) - ???
modifications (noun) - modification
moindre (adjective) - lesser
moins (adverb) - less
moins (noun) - minus
moins (preposition) - wanting
moitié (adverb) - half
moitié (noun) - half
molybdates (?) - ???
moments (noun) - time
monde (noun) - world
monsieur (abbreviation) - Mr.
monsieur (noun) - sir
montrer (verb) - show
morceau (noun) - piece
mordis (verb) - bite
moselle (noun) - moselle
mot (noun) - word
mots (noun) - word
mourra (verb) - die
mouvement (noun) - movement
murmurait (verb) - murmur
muscade (?) - ???
muser (?) - ???
musée (noun) - museum
mystifier (verb) - mystify
méchant (adjective) - wicked
méchant (noun) - naughty child
méchants (adjective) - wicked
méchants (noun) - naughty child
métalliques (adjective) - metallic
métaux (noun) - metal
nationales (adjective) - national
nature (noun) - nature
neuvième (adjective) - ninth
neuvième () - ninth
neveu (noun) - nephew
nez (noun) - nose
ni (conjunction) - or
ni (adverb) - neither
nitrique (adjective) - nitric
noisette (noun) - hazelnut
noisette (adjective) - hazel
nom (noun) - name
nombreuses (adjective) - numerous
noms (noun) - name
non (adverb) - not
non (particle) - no
norvégiens (adjective) - Norwegian
norvégiens (noun) - Norwegian
numéro (noun) - number
obligé (adjective) - obliged
obtenir (verb) - get
obéir (verb) - obey
occupait (verb) - occupy
odeur (noun) - smell
odin (?) - ???
oeil (noun) - eye
offre (noun) - offer
omelette (noun) - omelette
oncle (noun) - uncle
opinion (noun) - opinion
or (noun) - gold
orateur (noun) - speaker
ordre (noun) - order
oreille (noun) - ear
organiques (adjective) - organic
original (adjective) - original
original (noun) - original
orme (noun) - elm
orphelin (adjective) - orphan
orphelin (noun) - orphan
oseille (noun) - boodle
otto (?) - ???
oui (particle) - yes
oui (noun) - yea
ouvert (adjective) - open
ouvrage (noun) - work
ouvrait (verb) - open
ouvre (verb) - open
ouvrit (verb) - open
page (noun) - page
palpitantes (adjective) - exciting
papier (noun) - paper
paraissait (verb) - seem
parchemin (noun) - parchment
pardonnable (adjective) - pardonable
pareil (adjective) - such
pareil (pronoun) - the same
pareil (noun) - equal
pareille (adjective) - such
pareille (noun) - equal
parfait (adjective) - perfect
parfait (noun) - perfect
parfois (adverb) - sometimes
parlait (verb) - speak
parlant (adjective) - speaking
parle (adjective) - spoken
parle (noun) - colloquial
parlât (verb) - speak
parmi (preposition) - among
paroles (noun) - words
part (noun) - share
paru (verb) - seem
passage (noun) - passage
passages (noun) - passage
passait (verb) - pass
passants (adjective) - elapsing
passants (noun) - passer-by
pauvre (adjective) - poor
pauvre (noun) - poor person
peau (noun) - skin
peine (noun) - penalty
penchait (verb) - lean
pendait (verb) - hang
pendant (preposition) - for
pendant (adverb) - through
pendant (adjective) - pending
pendant (noun) - pendant
pensée (noun) - thought
perdus (adjective) - lost
permettait (verb) - allow
permis (adjective) - allowed
permis (noun) - permit
persil (noun) - parsley
personnage (noun) - character
petit (adjective) - small
petit (noun) - child
petite (adjective) - small
petite (noun) - child
peu (adverb) - little
peu (noun) - bit
peu (adjective) - few
peut (verb) - can
philosophie (noun) - philosophy
pieds (noun) - foot
pierres (noun) - flagging
pignon (noun) - pinion
place (noun) - square
plaire (verb) - please
planches (noun) - planking
planté (adjective) - robust
plats (adjective) - flat
plats (noun) - flat
plomb (noun) - lead
plu (verb) - please
plus (adjective) - more
plus (adverb) - more
plus (noun) - plus
poils (noun) - pile
poings (noun) - dukes
point (noun) - point
pointe (noun) - tip
polyglotte (adjective) - polyglot
polyglotte (noun) - polyglot
portait (verb) - wear
porte (noun) - door
pots (noun) - pot
pouces (noun) - inch
poulie (noun) - pulley
pourquoi (adverb) - why
pourquoi (conjunction) - wherefore
pourtant (conjunction) - yet
pourtant (adverb) - nevertheless
poussait (verb) - push
pousser (verb) - push
poussière (noun) - dust
pouvaient (verb) - can
pouvais (verb) - can
pouvait (verb) - can
poète (noun) - poet
première (noun) - premiere
prenant (?) - ???
prends (verb) - take
pressé (adjective) - pressed
princes (noun) - prince
printemps (noun) - spring
prix (noun) - price
professait (verb) - profess
professeur (noun) - professor
professeurs (noun) - professor
profonde (adjective) - deep
prononcer (verb) - pronounce
prononciation (noun) - pronunciation
propre (adjective) - own
propre (noun) - proper
propres (adjective) - own
propres (noun) - proper
propriétaire (noun) - owner
propriétaire (adjective) - proprietary
propriété (noun) - property
prosterner (?) - ???
prudemment (adverb) - carefully
prunes (noun) - plum
précieuse (adjective) - precious
précieux (adjective) - precious
précipita (verb) - precipitate
précipitai (verb) - precipitate
précipitamment (adverb) - hastily
précipite (adjective) - precipitate
préoccupât (verb) - concern
préparais (verb) - prepare
préparateur (noun) - preparator
présage (noun) - presage
présageait (verb) - predict
présence (noun) - presence
préserver (verb) - preserve
prétendaient (verb) - claim
prévoyais (verb) - provide
public (adjective) - public
public (noun) - public
puis (adverb) - then
puits (noun) - well
pure (adjective) - clean
purgold (?) - ???
qualité (noun) - quality
quand (adverb) - when
quand (conjunction) - when
quartier (noun) - neighborhood
quarto (?) - ???
quatre (noun) - four
quatre () - four
quel (adjective) - what
quel (pronoun) - what
quelconque (adjective) - any
quelconque (pronoun) - some or other
quelle (adjective) - what
quelle (pronoun) - which
quelque (adjective) - some
quelque (adverb) - about
quelques (adjective) - a few
questions (noun) - question
quoi (pronoun) - what
raison (noun) - reason
rapide (adjective) - fast
rapide (noun) - rapid
rappela (verb) - remember
rebroussés (verb) - turn back
reconstruire (verb) - rebuild
redoutable (adjective) - formidable
regagna (verb) - regain
regagner (verb) - regain
regarde (verb) - look
regrettable (adjective) - regrettable
relative (adjective) - relative
relevant (verb) - raise
relevée (adjective) - raised
reliure (noun) - binding
rencontré (noun) - meeting
rendre (verb) - render
renommée (noun) - renown
rentre (verb) - return
reprenait (verb) - resume
reprit (?) - ???
représentez (verb) - represent
respecté (verb) - respect
ressemblait (verb) - look like
restai (verb) - stay
reste (noun) - rest
retard (noun) - delay
retentissait (verb) - sound
retentissante (adjective) - resounding
retentissantes (adjective) - resounding
revint (verb) - return
rhomboédriques (?) - ???
riait (verb) - laugh
riche (adjective) - rich
riche (noun) - rich person
rien (noun) - nothing
rien (pronoun) - anything
rien (adverb) - nix
riposta (verb) - hit back
rois (noun) - king
roulaient (verb) - roll
rudes (adjective) - rough
rue (noun) - street
rues (noun) - street
runes (noun) - rune
runique (adjective) - runic
russie (noun) - Russia
règne (noun) - reign
récalcitrant (adjective) - recalcitrant
régnèrent (verb) - reign
régulièrement (adverb) - regularly
répliquai (verb) - reply
réplique (noun) - replica
répondis (verb) - answer
répondit (verb) - answer
réponse (noun) - response
réponses (noun) - response
résines (noun) - resin
résistent (verb) - resist
réséda (noun) - reseda
rétinasphaltes (?) - ???
sabine (?) - ???
saint (adjective) - saint
saint (noun) - saint
saint (abbreviation) - St.
salle (noun) - room
salon (noun) - lounge
sang (noun) - blood
sans (preposition) - without
santé (noun) - health
saurais (verb) - know
sauve (adjective) - safe
savait (verb) - know
savant (adjective) - learned
savant (noun) - scholar
savants (adjective) - learned
savants (noun) - scholar
savoir (verb) - know
savoir (noun) - knowledge
science (noun) - science
sciences (noun) - science
scientifique (adjective) - scientific
scientifique (noun) - scientist
scientifiques (adjective) - scientific
scientifiques (noun) - scientist
scène (noun) - scene
sels (noun) - salts
sembla (verb) - seem
semblaient (verb) - seem
semi (prefix) - semi-
sept (noun) - seven
sept () - seven
servant (noun) - servant
servante (noun) - servant
servie (verb) - serve
seul (adjective) - only
seul (noun) - only one
seul (adverb) - very
seule (adjective) - only
seule (noun) - only one
si (conjunction) - if
si (adverb) - so
si (noun) - si
signe (noun) - sign
signes (noun) - cracks
signet (noun) - marker
signifier (verb) - mean
similé (?) - ???
simple (adjective) - simple
simple (noun) - singles
sinon (conjunction) - otherwise
sinon (adverb) - or else
sinueux (adjective) - winding
située (adjective) - situated
six (noun) - six
six () - six
siècle (noun) - century
snorre (?) - ???
soigneusement (adverb) - carefully
solennité (noun) - solemnity
solidement (adverb) - firmly
somme (noun) - sum
songeais (verb) - reflect
sonner (verb) - ring
sonnèrent (verb) - ring
sortir (verb) - exit
sortis (verb) - exit
soucie (?) - ???
soupe (noun) - soup
sous (preposition) - under
sous (adverb) - underneath
sous (noun) - cash
souvent (adverb) - often
spécimens (noun) - specimen
strasse (?) - ???
struve (?) - ???
stupéfaite (?) - ???
subjectivement (?) - ???
successivement (?) - ???
succès (noun) - success
sucre (noun) - sugar
suffi (verb) - suffice
suite (noun) - suite
suivaient (verb) - follow
suivant (adjective) - following
suivant (preposition) - according to
suivant (adverb) - as follows
surface (noun) - surface
surtout (adverb) - mainly
séparer (verb) - separate
série (noun) - series
tabac (noun) - tobacco
table (noun) - table
tangasites (?) - ???
tant (adverb) - so such
temps (noun) - time
tempérament (noun) - temperament
tenais (verb) - hold
tenait (verb) - hold
tendait (verb) - tender
terre (noun) - earth
terrible (adjective) - terrible
terriblement (adverb) - terribly
tiens (interjection) - Hallo!
tirer (verb) - take
titaniates (?) - ???
titre (noun) - title
toise (noun) - measure
toit (noun) - roof
tomba (verb) - fall
toujours (adverb) - always
tourbes (noun) - peat
tous (adjective) - all
tous (pronoun) - everything
tout (adjective) - all
tout (adverb) - all
tout (noun) - all
tout (pronoun) - all
toute (adjective) - all
toutes (adjective) - all
tradition (noun) - tradition
traduction (noun) - translation
traité (noun) - treaty
traité (adjective) - processed
transcendante (adjective) - transcendent
transversales (noun) - transversal
travail (noun) - work
travers (noun) - breadth
traversant (verb) - cross
trois (noun) - three
trois () - three
trop (adverb) - too
trouvai (verb) - find
trouvaient (verb) - find
trouve (adjective) - found
trouverait (verb) - find
très (adverb) - very
trésor (noun) - treasure
tugendbund (?) - ???
tungstates (?) - ???
turleson (?) - ???
types (noun) - type
tête (noun) - head
uni (adjective) - united
usités (adjective) - in use
utrecht (?) - ???
va (verb) - go
valeur (noun) - value
variées (adjective) - varied
vas (verb) - go
veau (noun) - calf
veines (verb) - vein
velours (noun) - velvet
venaient (verb) - come
ventre (noun) - belly
verne (?) - ???
vers (preposition) - to
vers (adverb) - about
vers (noun) - verse
veux (verb) - want
vieil (adjective) - old
vieille (noun) - old woman
vient (verb) - come
vieux (adjective) - old
vieux (noun) - old man
vif (adjective) - bright
vif (noun) - quick
vigoureusement (adverb) - vigorously
ville (noun) - city
vin (noun) - wine
vint (verb) - come
violente (adjective) - violent
virlandaise (?) - ???
visite (noun) - visit
vitraux (noun) - stained glass
vivement (adverb) - deeply
vivre (verb) - live
voici (preposition) - here is
voici (phrase) - this is
voilà (adverb) - here
voir (verb) - see
vois (verb) - see
voix (noun) - voice
volai (verb) - fly
volontiers (adverb) - willingly
volubilis (?) - ???
volume (noun) - volume
voluptés (noun) - sensuousness
voulait (verb) - want
voyage (noun) - travel
vrai (adjective) - true
vrai (noun) - right
vraiment (adverb) - really
vraisemblablement (adverb) - in all likelihood
vu (adjective) - understood
vu (phrase) - got it
véritable (adjective) - true
yeux (noun) - eye
zircone (?) - ???
âge (noun) - age
ébranlé (adjective) - shaken
échantillons (noun) - sample
écorcheraient (verb) - skin
écria (?) - ???
écriai (?) - ???
écriait (?) - ???
écriture (noun) - writing
égalité (noun) - equality
égoïste (adjective) - selfish
égoïste (noun) - egoist
élançai (?) - ???
élèves (noun) - student
épaules (noun) - shoulders
épousseter (verb) - dust
épouvantable (adjective) - terrible
étiquetés (verb) - label
étrange (adjective) - strange
étudiant (adjective) - student
étudiant (noun) - student
événement (noun) - event
être (verb) - be
ôtait (verb) - remove
